X CCC XXCCXX
CX XXCCX CCC
CCCXXCX X X 
CXXCXXCC CXC
      C SCXC
 C C XXXC X 
 XX XC CC XX
CXX XXXXCC  