XXTTTX  XTXT
T  XX  T XXX
XX T X XXX  
X XXXTXTXXTX
X XX TT X  T
XXXX  X XXXX
 TXXXTSX TXX
XTXXX XT X  