XCD X WW  D 
 CWCACD   DW
DC X C XWDK 
WXX  XKWCWD 
 DD CD XX  C
 DDDKWCC X D
WD DWDDSKD D
XX DDCCCCCWK