KC K  XWXXDX
WDKXDDKWDXX 
CXWDXDCDK C 
X CS  CK WCC
DKWXWDWXXDX 
KC DCXCA C K
       DXKCX
W W  DKDCKDW