 KDXXXX DK X
DDXSKX  DXXK
DKXK XDDK   
DDX DDDXXXXX
D DXKD XX D 
DX D KXDD DD
DXXD DXXDKXD
XXKXXXXD DXK