C    XX X X 
 X C C CCCXC
CCCCC XX  C 
CXXX C C   X
X X C XX XCX
CC C  CC  CC
C XSCXXCCX C
XXXCX XCXCC 