XT XTXX  X T
X XXXTTXT TX
XXXSXXTXXXXX
XXX XXTX   T
 XTTX  T TX 
XXT  T  XX X
X TXXXXXXX X
XXTX XTT T X