T T XTXTXXXX
   X TTXXX  
 XTTXTXXT XX
    X TX XXX
TXXXXT  TXTX
 TXTXXTX TSX
XTXX TXTXXTX
 XXX XX XTTT