XXX XXXXXXX 
XX X X XXX  
XX X XXX   X
XXXXX S   XX
XXXXX  XXXXX
 XX XX XXXXX
XX XXXXXXXX 
XXXX XXXXXX 