CCXTTCX X TT
X T TCCXCC C
 CC CCXTC X 
CXTTX C TXTC
 XCX CXSXXCC
 C TXXXT CT 
  XX  CTX XT
 X   TXC  X 