XXXXX XXX XX
 XXXXXTT TXT
 XX   T XXT 
  XTX XTT   
TTXSXXXXX XX
X  XXTX   T 
T XXX XXX XX
  TTTX X  XX