DX DXXXKDKXD
XXDDKD XDDX 
K KXDXXKDDXX
K DKX KDD XK
X DD DXXXD X
DKX XDK SX X
 XDDDDDXKXX 
DK X XXDXD X