 XXCCC C CCC
XXXXX X XXCC
CC  X X XC X
CC XCCCCXSXX
XCXCC XCCCCC
CXCC CX   X 
XCCXX CC  XX
XX XX   XCX 