  WDXDKWAW K
DXDDXD  W  K
X DKXXD  W K
WDD A DDADDD
XD DX SX D K
W W XWXADD X
KDKDDWDXW W 
WWWX XWDDDX 