 XDDDXDXXX X
XK  D X XXDK
XD D DXXX DD
 DD  X   XD 
X DX DSKXDXX
 DXD  D X DK
 DKXXKXX D  
DXDK XXXXXXX