WD X KKDW  C
CD C DXKW CX
DCCKXX DW K 
DDADC X W C 
 DCD C DDDXX
XDXDD C   CC
W KXXKX XS C
C KCX CWXXCW