DD XX DDKWDW
KDXWDW  DDDD
XX  DXXDDDDD
D XDXXXAX DX
D WXAXW SK X
 DX D D AWDD
A WKXD XDDXX
K ADWAW D KK