   XXTXXXTTX
XXX X XXXXXX
XXXXTTXT  X 
X T XT TXTSX
 XTX XX X TX
  XXTX XTX X
TXX TX TTTXT
TXXXXXXTTXXT