 X  XCX TXCC
X XTTXCXXS X
 TT XTCX   C
 C C X X CXC
 CXT T CC  T
  XXTXX X CX
XCXXTC XC CC
XC CCCX   X 