X XXXXXXX XX
XXXXXX XX X 
XXX  XXX XXX
XXS  XX XXXX
 X X X XXXXX
XXX  X X  XX
X  X  XXXXX 
 XXX XX XXXX