DWDWKCC C C 
 DX X TXCD D
KX X X  XDW 
 WSDDWDDDDC 
XW   CK  KXA
WCD CDCTX CD
X WDXWX XCDA
XC XTTKDCCXD