  WDXWDXXX  
DD XCDXW  CW
 X  C WX  XD
C CK DSC A X
XCDCXWDDXDDC
WW WD  C WDC
 KXWCW DCKXK
 DD  D XX KX