  C  XXCCC X
CCCXX XCCX X
XX SCCXCXCX 
XC CC CCCX C
 CX XXCXXXXC
CX  C XCX CC
 XX C C    C
CXXC  X    X