KXW    AD KX
KA DDDXWDDXX
XDWWXX    XD
X XXD XDDXDK
 KDDW SDKDXW
XXXKADAWXXDX
 W XWDWW XKX
DK DWDXK DWK