XC  C  C   X
C  C CX CCCX
CCCCCCXC   X
C XCXCCSXXCX
X CCCC C CC 
XX X CCXXXXC
X X CCX  CX 
 X  X  X XXX