W  TD CCA C 
XC C D XD DX
C   W TWDW K
C TXDC XC T 
XWW WWSDDKKD
  TD CTCWC  
WWX D DWW D 
T XCDCCXCC  