 XXX XX   T 
TTT TX TTX X
 TX XXXX TTX
T X TST X TX
X X XX TXXX 
XX T TXXXX  
TX XXX X T X
 XXTT   XX  