C  CCC X T C
TX X   CT CT
CXXXCTCTCCC 
XXXX  C C CC
  C  XSC CC 
 C XX X X  C
XXXC  X CXCT
  CXTCTCT  X