T XXTXTTXXXX
XX TXTTTXX T
TXTXXT TX TT
XTTT T XXXTT
XXSX XXXXTXX
XTTX XTXTXXX
T X XXXXTX T
TXXXT T TXXX