K KDD X  K K
KDDXXDX  XDD
XXXDXDXX  DD
KDX X XKX  K
KDK  XS XKKD
DKXDD DX DDD
X  XDXKX XDX
X KDX XD KX 