XX X XXXXXXX
X XXX  XX XX
X X   X   XX
X  XXXXSX   
XX XXXX X  X
   X X  XXXX
 XXXX XXX XX
XXX XXXXXX X