  XXTTWC WT 
X  DDXSKTX D
 D XC DXDD X
WD CCDC XDKD
DCDTKK CWWXC
D X   D   WX
XC T  XDT DW
WXCDCX XDCXC