   XXCCCC  C
CXC TX  CCX 
   XTCTTX CC
X XXXCXXXXCC
XXXCXTXCTSXX
XCC CC   C T
 XXXCCCC XTT
TC XC T TXX 