  XXXX XXXXX
XX XSXX XXXX
X XX X XXX X
XXXX       X
 XX XX  X   
 XXXX XXXX X
XX XXXXX X X
  X   X XX X