K  KD X DDK 
 X XXDDKDDXD
XXX DXXDDX D
DXK KXXXD XD
 DDXDDKD  XD
 DD XXKXS  X
 XX  DXDXKXD
 D  DXXDXXXD