XXCCX  X  XC
DTWDDX   DCW
D K   CW D X
TXDCT CXDC D
DTCSDD XDWA 
  CCDT X C X
XXDDDT C T W
 XX C  W   W