  KKWXAXD KX
KDWX X D  A 
X  X   KD  X
WX DDK D WX 
D DX XWADDX 
  W WXWXK XX
XX KDXSKDDW 
DDWDX XXWDWX