KXDDDKXDW XX
 CX  DTC  XX
C WC XDDKCXC
 WDCT C WSDC
 K  XC W CT 
    AW TXTCT
CDDXDXT XCWX
TCT DK XDDK 