XX CC CCTXCT
TX C CTXCX T
  TXC  X XTX
TCCXCXTCCCTC
 TTCXCC X C 
 CX  XX S C 
XXC CXTXCCX 
TT TCCTXTXCC