C   CXXC  CX
XCCCCCXCX XX
  CSXX  X X 
X C CX  XC C
CXXXXXX XX C
XXCCXXCCXCCX
  X   XXCX X
XCCC CCXX CC