KKW XWXXX CD
ACXTDXWXC  C
D CXWTX X CK
CC   CX XC X
DT CX  WSD  
XDT   XTTXDC
DDWCDDDT CT 
XXDDX  XCXW 