XD  WWCDCC  
 XD X   C CW
XD XC KDXWSX
DXDDC CX DXD
 X CWXXXDWDD
DXC   CKDXX 
KCC DC CXWXK
XCC CDDKCXCX