 X X  XXXXXX
XXXXXX X X X
X  XXX XXXXX
XXXX    XXXX
X    XX XXXX
XXXXSXX X X 
X  X  X XX X
X XXXXX  XXX