DXXXXXDDD  D
DD KDKXKX XX
KXDDD  XDXDD
KXKX  XXDDDD
 XD D K KDDX
XS DXKXX XXD
KXKX DDXX   
XXXDDD  KXXX