DD  DWDDWXKA
  XDDX DXKX 
DWDK  DW KSW
XK DXDADDWX 
D WW XXXDW X
DX DX XXDWWK
 XKD X D WKW
 X KXX  KWDW