X XXXXX XX  
 XXXX XX  X 
XX X  X   SX
XX XX   XX X
XXXXXX XXXXX
XXXXXX    XX
XX XXXX  XXX
XXX  XX X XX