DCXCCKX    D
 XDCDX KCDD 
D C   XWDD  
 CCXDD X   X
CA KKKW  DX 
CC X X KW  C
WSCXX  DCCKW
DWKKCDDC KCW