XXC CCXXXX C
XXXXS CC X X
CX   CXXXCCX
X XCXXXXXCXX
 XX XXXX   X
C X  CXX XXC
 XC C XXCC  
     CCCXCXX