  XXXX XXXXX
XXX XXXXXXXX
 XXSXX XX XX
 XX XXXXXXXX
XXX     XXXX
XXXX X   XXX
 XXXX X    X
XX X XXXXX  