X XXXXXX X X
 XX X  XXXXX
XX  XS  XXX 
XXXX XX XXXX
XXX     XXXX
 X X  XX XXX
 XX  XX X  X
XX  XXXX  XX