D C W D  WDD
D  DDXXDXTW 
KW X WS XKD 
DWWD W CKCCC
 DCTWD TC C 
 XXD TW DCDX
WXDCKCXC  CD
XWCKTKX TC K