 DDXDXXK D X
  XXXSDXXX  
KD XXK DD DD
XDKKXKXDXDKK
 XXDXXXK XKX
DXXDD XK XX 
D D  DXDXKDD
X X XXXXDK K