XXXDDDDXX D 
  D D D XXDD
  K D  XKSX 
   D XXK  X 
   XXK XXDXD
KXKDDDDDDDD 
 KDDX  DDKXD
DX  X D XXX 