XC C XCCX  C
XC  XC  CX  
XCCCCCXXXCCX
CX   CSC X C
 CCXXCXC   C
  XCXXC CX X
CXC    CCXX 
 X C CXCCCX 