 XXC XX XXCT
X  TT TXTT X
TX TXC  CCSX
 C TC  XX XC
 TX XCXCXT X
TCCX   XX  T
 XX TT TXX C
TX TXXXXXT  