W C X   KW  
 DC XXCCXXXD
 XXD D W DW 
TDKC  CSDCDT
DC C  T W DK
  KDWCTDCK D
D  TXDT TACD
CXD X CKDCCA