XKC   XKTD X
XC X  CDCWCD
TC D  WX  D 
XD CDXXAXSAD
KDW CKC TTCX
XKDD  XCCCTC
 KD  CXKDX C
D TX K KWT  