C TXXXT XCC 
XC  CTCC XTX
TTCXX SXCC C
XXXXCXXC T T
CC C X XC CX
CCC CX  C XX
C CXCXCXXX X
 T CCCXCT CX