XX XX XXXX  
XXXXXXXX XX 
X XXXXX XXXX
 XXX  SXXXXX
XXXX XXX XXX
XXXX  XXXXX 
X  XX   X X 
XXXXXXX XXXX