X  X XX XXX 
XTXXTXXTSTX 
X  XXXX T XX
TXT  TXTXXXX
XXXTT T X XX
X XTTXXT  XT
X XT   XTXTT
X T   XT TX 