X T   CXCXXX
 C TXTCXXSCX
CXT CXTXCTX 
CTCXCC CTTX 
XXCCT T TTCC
XXTXCT X XX 
 CCCTXCX  CC
T    CXX XC 