   DC C  XWC
 DWXD   AD D
W CXXXK C  K
DX CK CC CDX
XXS DDKX XCK
KXDD C   W  
CWXXW D WXD 
  W XX XKCK 