X CXCXXXC C 
XXXC   XCXC 
C   CXXXXX  
 XX XX C    
XXCC XSXCCX 
 C XCXXXCCXC
CX CC X XXXX
C  XX C X C 