 TXTTXXT XXT
XXXTXT XT X 
XX XXTX   XT
  XSTX  XXXX
XXXTTXX XXX 
TTTX TTT XXX
 XX TTXT XXX
  TXXXXXXXX 