CX   X C  CC
C  XXCXX C  
X CCXXCCC C 
 XXX C C CCC
XCC XCXCC  C
C XXC CCCC C
CXCCXCX XXSX
     X C CXC