XXX TXX XXXX
XX XX XXT XT
 XXXXX SX X 
XXXT XTTTXXT
X XTTTT  XTX
X X XXXX XTX
XTTTX TXTXXX
X XXTTXXXX  