X TCXX CX  T
 XC CTXXTCC 
CXXXCSXXXXTC
 XXCC XCCTCC
CC CCTCCXXX 
XXT  C XX XX
CCCXXT  C CX
XTCCCTCXXC C