XXWXKWXW  XX
X WWXXDDXX D
XD XX XW  X 
K KXXD   XWX
K WKDK XXX X
KW WX  WASDD
D DD WWXX KX
D XD  XDDXXX