XKDD  DKD   
X KDXDDX D X
DDXDDDXXDXXX
 X DXKXKX XX
 D XD DS KXX
 K  XX XXXXD
XXXDKXX XDXK
X XDDXDDDXKK