KX XDWXDDD D
XX XDWA  WXD
D W XKDW D  
KW   D DSDD 
 K XXXDXDXDK
D DXXWD    D
 WWXD DXD  K
 DXD  XKKXAD