CC  CCCCCXX 
CCCC X  TTCT
XCX XT XX XX
X XXXXS  TXC
CXCCCXXXT  X
X XCXCX TXXT
C C TXXXTXC 
CX XTCTCXX C