DK  DDDDXDKK
XXDKXXDXDDDD
  XDD KXXDD 
 XXD XXD X X
DDKX K XDXDX
DDDXSX  X D 
DD DX XXXDDK
DKK XXDDX DK