 XCXCCCCXXXD
C    C DDDC 
 CKCD  DD DD
XKCWD WCKCXD
X DXDXC DKCD
XCXS KKWXK C
DXXWWDCKX  D
 D KWXCA C  