K  KKDDXDXDX
D  KXKXADXDD
 X  D X KX W
 AD  K D XDX
XW DDDKXWAD 
XX XW DDKD X
AWKX  XXSWD 
DAXKW   XXXX