WKDWWDDX    
 KDX XX WDDX
WXKX  K X   
WXXKDKKXKD X
 WAWKDDKXDD 
D DWDXXDSDDD
 X XWXD KXX 
WDWX  XXX KD