DCXCCXDD    
XKDK DXCD CC
 DX C W ACDD
 X XCX WD SC
 CK XDWC  DW
 X X DCCWD D
  AWDDCW CX 
A WXDW DDXD 