XXXX  X  XXX
XX XXXX X XX
XXXX XXXXXXX
XXXXXX    SX
XX XXXXX  XX
  XX   X XXX
X XXXXXX    
XXXX X  XXXX