CWCCXXCKWDDX
W CDDKWWCCSD
  D XD K CCC
W  CDK XXDK 
CCWKXDCXCDD 
CDDXX CKCCCD
W C KDWD WXD
D WC  CCW XC