CX  XX CXCCX
CX  X X   XC
X  CCX XCXX 
CC C XCCCX X
CXCXXCCCX XC
C CS C C CX 
XX XC C XXX 
CXCXCCCXC   