X   XXXX XX 
XX XXXX XX X
X       XXXX
X XXXXX S X 
XX XX  XXX  
X XXXXX X XX
XXX X XX XXX
XXX X XXXXXX