  XXCX CX X 
   C X X  C 
XXX  XCXXXXX
 XXC  C CXXC
 XX XXXXXCC 
XS  XCCC CX 
XXXX C CC XC
CXCX   CC CX