XC DDXC  C W
 XD C CCDWAC
 XKDT  CXSW 
W WWXCDKT C 
DWWKC AD W D
 D CCCDWXD C
    K WCD T 
XXKCWD DD DD