CXW CWCXD KD
CDKX DSDCAD 
CK K CCCDCCD
DD CD  XW  D
DCDCDCX  C C
XDWAXKWWCDKX
 DCXW D DD D
XKXD WDXCCK 