 XKXXXXXD   
XXX KD KX K 
X   XDDDXDDK
XDS DXX D DX
 XDDXK  D  X
K XDXDXKD X 
DDXX XKDD DX
DX  XD  KX K