  KDCDCD  CC
 D XXXCCXCDK
CC DW WDXWCC
 CKD X CCCDD
CWW X S DC  
 CCX C C K X
DXD X DWXDC 
XX X XDDCX K