XX XXX   XXX
XXXX XXX  X 
 X    XXX XX
XXXXXS X   X
XX   X   XX 
XXXXXX XXXXX
XXXXXXX  X  
XX XX  X XXX