KXD XX W X K
  XDW DXD W 
  X DXDXDX  
KXXW XXWDDD 
XX ADWKAWWK 
XDW S X WDXW
X X XX XD XX
 XKXX W XXXD