  D  DDXD DD
KK KXXXDD XK
XK   KDKXXDD
  K DXXDK XK
 DDDX  KDX D
DDDDDXK DXDX
X D XXDDKSXK
D DK DDXXX K