ADK   XD XKW
 KDXK  DWX W
W X  XXWXX  
D DDXXD D XD
W  DAKW W WW
KX  XDD   DX
 KXXDDXASDW 
XKXWXWDXDX D