 XD KDDDXD  
  D KX   KD 
XXDDXDXDK  X
XD DDKDKDX X
X XDKXXXDXXD
K X  X XXDK 
KXXSDXX  KDK
 X XXDX   XX