DC  D  CK CD
CSDCXWCK WWC
X C   CW  X 
DX WK W CXC 
XW  D  DKW C
CX DD CCXXCD
WKX D DC KWD
K   DDCD C X