X K KXXX  KX
KKXXX K XXX 
X KDDSX DD  
 XDXXX DXKXX
XX XK  DX DK
DDDKXXXKKX K
KXD XKDXXXXX
XDDKXDDKXD X