CXCXXX  CX C
 C STXX XCC 
 CX CXC T   
CTC XXC C C 
 TCC C  CXC 
  C CXT   CC
XTCCCTXC XXX
 XC XCXXC   