KK  K DXDD X
KD XXX DD DX
  XX   XDDKD
 XXXDXX KDKD
XDKXDSKX KXD
 KX XX D DKD
DKXKKXXXDD D
 D XXX DXKXX