XXXTTTTXXXTX
X XTXXXXX TX
X XTXXT X TX
  TXX   X X 
  X  TXX TXT
  TTTX XTX T
 TT  XST XXT
TX XX XXXXXT