  XXXXXX   X
  XX XX X  X
  X  XX XX X
XXXSXXXX X  
 X     XXX X
XXX  X XX X 
X XXXX X XX 
XX X   XX X 