XX X XX XX  
XXX XXXXX X 
XX XX XXXX X
XXXXXX XXXX 
 XX   SXX X 
XX  XXXX   X
    XXX XXXX
 XXXXX XX  X