K  XDKD    X
 DXSWX XDDKX
KXKKW  DXXX 
XWDDDXX D   
W   D   DD X
DXWW DXDXXD 
DW DKXDDDXDW
 XDDW  KDX  