K  DXDXK KC 
C    X WXW D
DCW DWXC SDT
 CXX   DT C 
CKX XDC CCDW
T W K  DD TK
  DKADCX TT 
 K KTCKC  WK