W DDW  XWWDD
KWAXKXW WDDX
K WK DXDW  X
 X W WS KDAX
DDAXXXWX DDW
  XDDWX XXDD
X X D XD DDX
DWD D DKDXX 