X XTX  TXTTT
XXT TXXXXXTX
XTXXS  XX X 
XX XXX TX TX
X   TXT TX X
XXXXTT X XTX
 XXX  X TXTX
XX X  X T  X