XX X XXX XXX
XXXX XX   XX
 XS X    X X
XX  X X XX X
XXX X   X XX
XXX   X XX X
   XXXX X XX
XXXXXX XX  X