 XC T T TC  
 CC CC XXXXC
CTT XT CC   
  CXC XT CXX
TTSXTT  XXTC
X C XX TCX  
TXTCT X C CX
TXX CCT  CTC