 CC WCC WDXD
DXDXSX ADXDD
 X  C W CCDA
DD    XXDT D
X K XX CDKXD
CDTXTXX DCWW
XCD  TT W  X
X XDC D X  C