XXC  X  CX X
C C X CC   X
 X  X  XXXXC
XXCCXCCS CXX
C C X X CC C
CCCC  C X XX
 XXXCCXXCX C
XCX CC   XXX