CX  ACWW W  
   DCDCXK TC
KXXCT K XDXC
XAKXC  D  DC
CWC KTKCWT X
DTCWCXX XDWC
WSXDX KC   T
 D DCCCC  K 