D XCDCD  X D
CXX   XXXCDC
  X D  D CW 
 D XD DKD C 
X  C  CK DXD
 DSD  CWWC X
CCCDWDDDAC D
D XDCDDCWA X