 XX  CXX   C
C  C XC CXXX
CXCCCSC CC C
X C C  C XCX
CXCCXX CCX X
 CCXCXX CX C
C CCXX CCC  
 C     CCCCC