KKDDXXD XKDD
 XXXXKXXKX X
X D S XDX D 
DDXXXKXDD K 
D  DDXXD XKD
  DDKD KKDKX
KK KXDD  DKK
 DDDK DDDXX 