KD  DXDX  DK
 XKK XKDXXKX
X KKXKXDKDDD
D XXD XKDXK 
 X XDKSDX XD
   KXKXDXXKD
XDDXXX XXXK 
  XD K KDKDX