A T WWDCC  C
 W   TD T CD
 TXWT D  K  
 X C W DCCDW
XTCC D DDC  
TDSX TCX DXT
DKX D KDCC  
 C  DXXCXDTD