 TXX X TXX  
 X XXXX XX T
X TX XTTT X 
TXT XT X  T 
XT XXTS XXTX
 XT  TXX XXT
XTXXTX   X  
X XT XX  TTX