XCXXXXCXCC X
XXC  XCXXC X
  X S    C C
XXCCXXCCXCCC
 CC C CCCXXC
X   CX XCCCC
 CCX X  C  C
C  XXXCXCXCC