 XCT CXXXC  
CXXCX  CCTCC
XCCTC C  CXX
CCC   XCT  C
X XC X XCCCC
X STXCCXXXX 
TCXXX  XXC  
TXTC CT XC T