XX  DXDXXX X
XWD KXXXKKX 
 KD XAXX  DX
X WWXW KD WX
KDXX DD DWWD
D KX DDSX XX
 XD XXD W DX
DXX X DX KDK