X CC XXXCXCC
X CXXCCTCXC 
X X TX XT  C
TT  T TCXXCC
TXTCTTXX X  
TCCSC C  XCX
CCXTX X XCXT
CTXCXX CC X 