TTXTXXXTXC  
 XX CCSCXXXX
CC  XCCTCXXX
XC XTT   TX 
TCCC XCCC   
XXCXX  CC XX
T CCXT CCTXX
CCCXTTC X   