X XXX CC    
 C  XX XXXC 
XX  X CX  XX
X CC CSX  X 
X   C CC CCX
 XCC  XC CC 
CCXX XXCCX  
XCXCXCXCCXXX