  CXX T TXCC
 TX  TCXTTXX
C XXXCTCXSCX
 CCTX X  TCC
  CX TXX  TT
 T XC XCC  C
C  CT CX CXX
TC C X CCXC 