X   XXCCXC X
C C  CC CCX 
CXCXXXX X CX
 XXX   CCXCC
XX  XCXXCCCX
  CCCXXSC XC
 C    C  X X
X XCCXCXXXC 