CK XDA C   A
DC XCCCDW WC
KW XXCDD DX 
XC X CWWCWXD
 KDKCDCKDDK 
  W WS CA CX
  XC WXDW DK
KX  WWAXCXXX