  TXXTX  XTC
TC XT CXC  C
X CT XXXSCCT
XXTXXXTCCCXC
CCTC TCXXCX 
C  TCXXXC TX
T CXX CX XC 
 TCCT X T TX