X XTXTXXTTX 
T TXTXX  TX 
  XXXX XTT X
 T T  X  XTX
     XX XS X
TT XXT XTXXT
 T XX X XX T
 XXXXTTX TT 