C WT XTWW CD
 A W ACT  DK
C CDDWXWK WK
DWCTD  DCDK 
W X TDTDC T 
CSC    TKCD 
DWCWDDXCCDWD
 T C XCCCD C