  CXXCXX CCX
CCCCXXCXC XX
XXXX CC XX X
 CC CX X C C
XXCXX XXCXC 
 C SCX  XXC 
 XCC   XXXXX
CX XC CCCXXC