XTTXX XXX TX
TT  TX  XXXX
 XX T S XTX 
XTT XTXTXTTX
XXX XX X  XT
X XTXX X X X
 TXX XTXXXXX
 TXXX   T  X