X   T   XXXC
 XXX  TX XC 
XCX  TXCC X 
C CT TT CCTX
 XCTTTCXT XT
CXX   C CSC 
 XTCC CCXCXT
C CX CXTTT C