 X   XXXT  X
   TXS TTX  
 X XXX TX TX
 XXXX XTXXTT
T XX X TTXXX
TXXXXT TXX X
X  TTT TTXXX
XTXT XXX X X