 KCDKCXCC CD
  KX XX  CCW
CDDDC   DCWD
CXCC  C DDKC
CX  X X  ACK
C DWCSDXXCDC
 KCDXXD  CX 
ACD C  XX XW