CXC CTXTX XT
XCXXC C XCXX
CC SXX TCXCX
CC CX TC CXC
TXTXTX XXXT 
XCTXXC  TXCC
TTTXCCC  XXX
 X X X  CX T