X  XXX X XXX
  XX  X X X 
 XXXXXX XXXX
XXXX  XXXX  
XX X    X X 
 XXX X XXXX 
X X  XS X   
XXXX XXX  X 