X T XX XXXTX
    TXTTXXXX
  X XT  XXTX
T  XXXXTXTXT
 XXXXS T TXX
TTTXTXXX X  
XXXXXX TXXT 
  X XXX XTTX