CC XXX X XXX
XXC X   XC X
 CXX C CCXXC
C C XCCX   X
C  XC  XXXX 
CCCX   X XXX
 X XCXSC CC 
C XC XCXX CC