  X WXXWDD K
X  D   XKXX 
A XX XWXDWXW
XKA DD SD DW
XXXDDXKDD W 
XKDXXWWDK DD
 WXDDXKDDWD 
DXWX DK XDX 