 XXDKXD K DX
D XD X  KXD 
DDD DDXD KXX
XS XXKX XDD 
XDK  DDX X X
XXXDXDXK KXK
 KXD  KDXXKD
    DDXK  KK