 XX XXXXXX  
X  XXXX XX  
X X  XXXXX  
 XX XXXX   X
  X   SX  XX
XXXXXX   XX 
XXXX  XXX X 
XXXX XX XXX 