DDCXDD XDWXX
KXXKCDXDK DK
XXXD KCD XDW
WXS  XDCW  X
CD XC DXXXX 
CCX C X W DD
DKX ACXXD CW
D CD XXK  KC