TXXXT TTXXTX
XXTX TTX TTX
X  XXX TXXT 
XT TXT XTT T
T XS T XXX X
XTXXTXXXT XX
TXTXXT  TXXX
   X X XXXXT