X XX XX XXXT
T TXXTXXX TX
TXXT XS TTXT
X T XTT XX T
 X T  X T XX
TXTXX  T XX 
 XXT XTXT T 
  XXX XXT XX