K DX XXXX XX
X KDXD DXDKD
D XDKD DDXDX
X KXDKDDKXXD
KXXXXDKD XDX
 KDDXKXXSDDD
 D D X X DDD
X D  XDXXXX 