DTCK   W  TX
 XCC DTKX KA
 DTX KDKKA C
D  TCX CTAX 
 C TKWCD XD 
XXDTDXWXDXX 
 XDSWWTXW TX
WX W D  TT K