 X XXCXXCX X
C C  C X CCX
 X  CXCX  XX
CXXC CXXC XC
XXXSXXXX   X
XCXC CC CCCX
XX  X XXCXC 
C  CCXXCXXXX