DX    XXXDXD
DKX X XX DKX
  DK X   DDX
D DK X XDXDK
XXX XXDS KXK
D XDXXKXDXXX
KD KDDX XDX 
K K  XDXDD X