 DXCC XWXCC 
  CDSCWXCCKD
DDCKK CWXCXX
K DWX KXX C 
C DK CCWWCC 
DDWDCWX WKXK
DX  C XDWK W
DD  KCCCCKXD