 XXTCXXCXCCX
CCXCX  XSCXT
 TT CCC   X 
   XXCTXTT C
CX C CXTTCTC
XC C T XX X 
XX CT CC  CT
 X TT X TXX 