XX XXXXXXXXX
XXX XS X XX 
XXXXX  XXXXX
XX     XXX X
XXX XXXX X  
X X  XXXX X 
XX   XXXX XX
  XX  XXXXXX