XDXXDXXX D D
WXKDXKKX KWX
XKXWXX XKWKK
D X KX DX XW
DWXSWDWD  DX
DA DD X KKX 
 XXDXADX XKX
DWKDW AW XKK