XXKDXX X DDD
XXXXD WKDXDX
DKXXWXKX KX 
 XDXK D DDDD
DXKWX WAXD D
K XD XWSWKXX
XKDXDXX XXK 
DK W  DX XD 