XXXXXXTTXTX 
 XXXXTTTX XX
XX XT XTXTTX
XX XX XTX   
XX XX TSTXTX
XXXXX XTXTX 
  XTTXT  TTX
XX XXXXXX T 