XXWDDCX XXK 
 CXTX C DXTD
CXDKX  D KW 
D XX A XDD K
C D DD CCWW 
CDT TW DK K 
 XDWXDTSDKDX
W XT DTDTKAD