 XWD DKKK   
 D KWD DK DK
W DWX D WD K
  WX XWKDDX 
 D DXD DD XD
XKXSAWKWDXXK
D D W DXDX  
DA DDWWW X D