DX KWXXX W  
DKDX DD DX W
DD DKXAK DAW
 X  WDXXXXD 
DDDA W KXD  
KXADDDSXXXDX
AX  D   XDWK
DWXXXWXXXKXK