XX XXXXX XXX
XXX XSXX  XX
   XX XX X X
 X XX XXXXXX
XX    XXX X 
X XXXXXX X X
XXXXXX XXXX 
XXXXXXX X XX