XX X X XX  X
   XXXXX XX 
X XXXX XX   
 X   XXXX X 
XXXXX S   X 
XXXXXXXXXXX 
 XX X  XXXXX
 XX XXXXXXXX